arc = car
elbow = below
state = taste
cider = cried
dusty = study
night = thing
inch = chin
brag = grab
cat = act
bored = robed
save = vase
angel = glean
listen = silent
silent = inlets
tar = rat
item = time
race = care
stop = pots
pots = stop
evil = vile
diary = dairy
edit = tide
golf = flog
fired = fried
post = spot
drawer = reward
stone = tones
earth = heart
mean = name
rats = star
ward = draw
read = dare
live = evil
part = trap
coast = ascot
dear = read
leap = pale
master = stream
pairs = paris
petal = plate
pares = spare
peat = tape
meal = male
owner = newer
plea = pale
note = tone
page = peag
pays = spay
rate = tear
seat = east
sheet = these
rail = liar
rent = tern
sink = skin
snap = pans
taps = spat
spot = post
tops = stop
wrap = warp
alert = later
alter = later
dole = lode
pane = neap
pest = sept
poet = tope
toner = tenor
routes = ouster
stealer = realest
rescues = secures
earing = regain
ladle = ladle
idle = deli
antler = rental
binder = brined
canter = nectar
cradle = reclad
duster = rusted
grained = deraign
relapse = pleaser
retrain = terrain
sated = dates
secure = rescue
sort = rots
spare = pears
strap = parts
parse = pears
reins = resin
siren = rinse
sorter = roster
stared = trades
teaser = reseat
vilest = livest
listen = enlist
